3,3,3,3,3,3,3,3,3,3,3,3,
0,9,0,0,0,0,0,0,0,0,0,0,
0,9,0,0,0,0,8,0,0,0,0,0,
0,9,0,0,0,0,0,0,0,0,0,0,
0,9,0,0,0,0,0,0,0,0,0,0,
0,9,0,0,0,0,0,0,0,0,0,0,
0,9,1,0,0,0,9,0,2,0,0,0,
3,3,3,3,3,3,9,3,3,3,3,3,
