3,3,3,0,0,0,3,3,3,3,3,3,
0,10,0,0,0,0,0,0,0,0,3,3,
3,3,3,0,0,5,9,3,3,0,5,3,
0,3,3,0,0,5,9,0,2,0,5,0,
0,0,3,3,0,5,9,0,0,9,5,0,
3,0,0,0,0,5,9,3,3,9,5,0,
3,3,0,1,0,6,0,0,0,9,0,0,
3,3,3,3,3,3,8,3,0,9,3,3,
