3,3,3,3,3,4,4,3,3,3,3,3,
0,0,0,0,0,0,0,0,0,0,0,9,
0,0,0,0,0,0,8,3,3,3,0,9,
3,3,3,3,3,0,0,0,0,0,0,9,
9,0,0,0,0,8,0,0,0,3,0,9,
9,0,0,0,0,9,9,0,0,0,3,9,
9,1,0,0,0,9,9,10,0,0,0,9,
3,3,3,3,3,9,9,3,3,3,3,3,
