3,3,3,3,3,3,3,3,3,3,3,3,3,3,3,3,
0,0,9,0,0,0,0,0,0,8,0,0,0,3,3,0,
0,0,9,0,0,0,0,0,0,0,0,0,0,3,3,0,
0,0,9,0,0,0,9,0,0,0,0,0,0,3,3,0,
0,10,0,0,0,7,9,0,0,0,0,0,2,3,3,0,
3,3,3,3,3,6,9,0,0,0,3,3,3,3,3,0,
0,0,0,0,0,6,9,0,0,0,3,3,3,3,3,0,
0,0,0,0,3,3,3,3,3,3,3,3,3,3,3,0,
0,1,0,3,3,3,3,3,3,3,3,0,0,0,0,0,
3,3,3,3,3,3,3,3,3,3,3,3,3,3,3,3,
