3,3,3,3,3,3,3,3,3,3,3,3,
0,0,0,0,0,0,0,0,0,0,0,0,
1,0,0,0,0,0,3,3,3,3,3,3,
3,3,0,0,0,0,3,0,2,0,0,6,
3,3,3,0,0,0,3,5,5,5,5,6,
0,0,3,3,0,0,3,5,5,5,5,6,
0,0,10,3,3,0,0,0,0,0,0,6,
3,3,3,3,3,3,3,3,3,3,3,3,
