3,3,3,3,3,3,3,3,3,3,3,3,3,3,3,3,
0,0,9,0,0,0,0,0,0,8,0,0,0,0,0,0,
0,3,9,0,0,0,0,0,0,0,0,0,0,0,9,0,
9,10,9,0,0,6,9,0,0,0,0,0,0,0,9,0,
9,0,2,0,0,6,9,0,0,0,0,0,0,0,9,0,
9,3,3,0,0,6,9,0,0,0,3,3,3,0,9,0,
9,0,0,0,0,6,9,0,0,0,3,3,3,0,9,0,
9,0,0,0,3,3,3,3,3,3,3,3,3,0,9,0,
0,1,0,3,3,3,3,3,3,3,3,0,0,0,0,0,
3,3,3,3,3,3,3,3,3,3,3,3,3,3,3,3,
