3,3,3,3,3,3,3,3,3,3,3,3,3,3,3,3,
3,3,3,0,0,0,0,0,0,0,0,0,0,0,0,3,
3,3,3,0,0,0,0,0,0,0,0,0,0,0,0,3,
3,3,3,0,0,0,0,0,0,0,0,0,0,0,2,3,
3,3,3,3,0,0,0,0,0,0,0,0,0,3,3,3,
0,0,0,10,0,0,0,0,0,0,0,3,0,0,0,0,
0,0,0,0,0,0,3,3,3,0,3,0,0,0,0,0,
3,3,3,3,0,0,0,0,0,0,0,0,0,0,0,0,
0,0,0,0,0,1,0,0,0,0,0,3,0,0,0,0,
3,3,3,3,3,3,3,3,3,0,3,3,0,0,0,0,
