3,3,3,3,3,3,3,3,3,3,3,3,
4,4,4,0,4,4,4,4,4,4,4,3,
4,4,0,4,4,4,4,4,4,4,4,3,
4,0,4,4,4,4,4,4,4,4,4,3,
0,4,4,4,4,4,4,4,4,4,4,3,
4,0,4,4,4,4,4,0,4,4,4,3,
4,4,1,0,0,4,0,0,4,2,4,3,
3,3,3,3,3,3,3,3,3,3,3,3,
