3,3,3,3,3,3,3,3,3,3,3,3,
0,0,0,0,0,0,0,0,0,0,0,0,
0,0,2,0,10,9,9,3,3,8,8,0,
3,3,3,3,9,9,9,0,0,0,0,8,
0,0,0,0,9,9,9,3,3,0,0,0,
3,3,3,0,9,9,0,0,0,0,0,0,
0,1,0,0,9,0,0,0,0,0,0,0,
3,3,3,3,3,3,3,3,3,3,3,3,
