3,3,3,3,3,3,3,3,3,3,9,9,
0,0,10,0,0,0,0,0,0,0,9,9,
0,0,8,8,3,3,3,0,0,0,9,9,
0,0,0,0,0,0,0,0,0,0,9,9,
3,3,0,0,0,0,0,0,0,3,0,9,
0,2,0,0,0,0,0,0,3,3,0,0,
0,1,0,0,0,0,0,3,3,3,0,0,
3,3,3,3,3,3,3,3,3,3,3,3,
