3,3,3,3,3,3,0,0,3,3,3,3,
6,0,0,0,0,0,0,0,0,3,10,0,
6,0,0,0,0,0,3,3,0,0,0,0,
6,0,0,0,0,0,0,0,0,0,0,2,
6,0,0,0,0,0,0,0,0,0,0,0,
6,0,0,0,0,0,0,0,0,0,0,0,
6,0,1,0,0,0,0,0,0,0,0,0,
3,3,3,3,3,3,0,0,3,3,3,3,
