3,3,3,0,0,3,3,3,3,3,3,3,
3,5,5,0,0,0,8,0,0,9,0,7,
5,9,9,3,3,0,0,5,0,9,0,3,
5,9,9,3,3,8,0,5,0,9,9,0,
0,2,0,5,5,9,0,3,3,3,9,0,
0,3,0,0,10,9,0,0,3,3,3,3,
5,5,5,5,0,0,1,0,3,3,3,3,
3,3,3,3,3,3,3,3,3,3,3,3,
