3,3,3,3,3,3,3,3,3,3,3,3,
0,0,0,0,0,0,0,0,0,0,0,0,
0,0,0,0,0,0,0,0,0,0,0,0,
3,3,0,0,0,0,0,0,2,4,4,0,
0,0,0,0,0,0,0,0,4,4,0,0,
0,0,0,0,0,3,3,0,4,4,3,3,
0,1,0,0,3,3,3,3,0,10,0,0,
3,3,3,3,3,3,3,3,3,3,3,3,
