3,3,3,0,0,0,3,3,3,3,3,3,
6,0,8,0,0,0,0,0,0,0,0,9,
6,0,0,8,10,5,5,5,5,0,9,9,
6,0,9,0,0,0,0,0,3,3,9,9,
3,3,9,9,0,0,0,0,0,0,9,2,
0,0,9,9,5,5,5,5,5,5,3,3,
0,1,0,0,0,0,0,0,0,0,0,0,
3,3,3,3,5,5,5,5,5,5,3,3,
