3,3,3,3,3,3,3,3,3,3,3,3,
0,0,0,0,0,0,0,0,0,0,6,0,
0,1,0,0,0,0,0,0,0,0,6,0,
3,3,3,3,3,3,3,3,3,3,3,3,
0,0,0,0,3,0,3,10,4,4,0,0,
3,3,3,0,0,0,3,3,3,3,0,0,
0,0,0,0,0,0,0,0,2,3,0,0,
3,3,3,3,3,3,3,3,3,3,3,3,
