3,3,3,3,3,3,3,3,3,3,3,3,
0,0,0,0,9,9,0,0,8,8,9,9,
3,3,3,0,8,9,0,0,9,9,9,9,
6,0,10,0,9,9,0,0,4,4,9,9,
6,0,0,0,9,0,3,4,9,9,9,9,
6,0,0,3,9,3,3,0,9,9,3,3,
6,1,3,3,0,0,0,0,9,9,2,3,
3,3,3,3,3,3,3,0,9,9,3,3,
