3,3,3,3,3,3,3,3,3,3,3,3,
0,9,0,0,0,0,8,0,0,0,0,0,
0,9,0,0,3,3,9,3,3,3,0,0,
0,9,0,0,0,0,0,0,0,10,0,0,
0,9,0,0,0,0,0,0,0,0,0,0,
0,9,0,0,0,0,9,3,4,4,3,3,
0,9,1,0,0,0,9,3,0,0,2,3,
3,3,3,3,3,3,3,3,3,3,3,3,
