5,5,5,5,5,5,5,5,5,5,5,5,
0,2,0,0,0,0,0,0,0,0,0,0,
0,0,0,0,0,0,0,0,0,0,0,0,
0,0,0,10,0,0,0,0,0,0,0,0,
3,3,3,4,4,0,0,0,0,0,0,0,
0,0,3,4,4,0,0,0,0,0,0,0,
0,0,0,4,4,0,0,0,0,0,3,0,
0,0,0,0,0,0,0,0,0,3,3,0,
