3,3,3,3,3,3,3,3,3,3,3,3,3,3,3,3,
0,0,0,0,0,0,0,0,0,0,0,0,0,0,0,0,
0,0,0,0,0,0,0,0,0,0,0,0,0,0,0,0,
0,0,0,0,0,0,0,0,0,0,0,0,0,0,0,0,
0,0,0,0,0,0,0,0,0,0,0,0,0,0,0,0,
3,3,3,3,3,3,9,3,3,3,0,0,0,0,0,0,
0,0,0,0,0,0,9,0,0,0,0,0,0,0,0,4,
0,0,0,0,0,0,9,0,0,4,0,0,0,0,4,4,
0,1,0,0,0,0,9,0,4,8,4,0,0,4,4,4,
3,3,3,3,3,3,3,3,3,3,3,3,3,3,3,3,
