3,3,3,3,3,3,3,3,3,3,3,3,
3,3,0,0,9,0,0,0,0,0,9,0,
3,0,0,0,9,3,0,0,0,0,9,0,
0,0,2,0,9,3,3,0,0,0,9,0,
0,0,3,3,9,3,9,0,0,3,0,0,
7,0,0,0,0,7,9,0,3,3,0,10,
7,1,0,0,0,7,9,8,3,3,0,0,
3,3,3,3,3,3,3,3,3,3,0,0,
