0,0,3,3,3,3,3,3,3,3,3,3,3,3,0,0,
0,0,0,0,0,0,0,0,0,0,0,0,0,0,0,0,
0,0,0,0,0,0,0,0,0,0,0,0,0,0,0,0,
0,0,0,0,0,0,0,0,0,0,0,0,0,0,0,0,
0,0,0,0,0,0,0,0,0,0,0,0,0,0,0,0,
0,0,0,0,0,4,5,0,0,0,3,0,0,0,0,0,
0,0,0,0,0,0,0,0,0,3,3,0,0,0,0,0,
0,0,0,1,0,0,0,0,3,3,3,0,0,0,0,0,
0,0,0,0,0,0,4,3,3,3,3,0,0,0,0,0,
0,0,3,3,3,3,3,3,3,3,3,3,3,3,0,0,
