3,3,3,3,3,3,3,3,3,3,3,3,
9,0,0,8,0,0,0,9,0,0,8,3,
9,0,0,9,3,3,0,9,0,0,0,3,
0,0,0,9,3,3,10,9,0,0,0,0,
0,3,3,9,2,3,3,0,0,0,0,0,
3,3,0,9,3,3,0,0,0,0,9,3,
3,3,0,0,0,1,0,0,0,0,9,0,
3,3,3,3,3,3,3,3,3,3,9,3,
