3,3,3,3,3,3,3,3,3,3,3,3,3,3,3,3,
0,0,0,9,0,0,0,0,0,0,0,0,0,0,0,0,
0,0,0,9,5,0,0,0,0,0,0,5,0,0,0,0,
0,0,0,9,0,3,3,3,3,0,0,0,0,0,0,0,
0,0,0,9,0,0,0,0,0,0,0,0,0,0,0,0,
0,0,3,9,3,0,2,0,0,9,0,0,0,0,0,0,
5,3,3,10,3,3,3,3,0,9,0,0,0,0,0,5,
5,0,0,0,0,0,0,0,0,9,0,0,0,0,0,5,
5,1,0,0,0,0,0,0,0,9,0,0,8,0,0,5,
3,3,3,3,3,3,3,3,3,3,3,3,3,3,3,3,
