3,3,3,3,3,3,3,3,3,3,3,3,
0,0,0,0,0,0,0,7,7,2,0,0,
0,0,0,0,0,0,0,7,7,0,0,0,
0,1,0,0,0,0,3,3,3,3,3,3,
3,3,3,0,0,0,0,0,0,0,0,0,
6,0,0,0,10,0,0,0,0,0,0,0,
6,0,0,0,0,0,0,0,0,0,0,0,
3,3,3,3,3,3,3,3,3,3,3,3,
