3,3,3,3,3,3,3,3,3,3,3,3,
0,0,0,0,0,0,8,0,0,9,0,0,
9,9,8,8,5,0,0,3,3,9,0,5,
9,9,0,7,5,2,0,3,0,9,0,5,
3,0,0,7,3,3,0,0,0,9,8,3,
3,3,0,7,0,0,0,0,0,0,0,6,
0,0,0,7,0,0,1,0,0,0,0,6,
4,4,4,4,3,3,3,3,3,3,3,3,
