3,3,3,3,3,3,3,3,3,3,3,3,3,3,3,3,
6,0,0,0,0,0,0,0,0,0,3,3,3,3,3,0,
6,0,0,0,0,0,0,0,0,0,9,0,0,0,3,0,
6,0,0,0,0,0,0,0,0,0,9,0,0,0,2,0,
6,0,0,0,0,0,0,0,0,0,9,0,0,0,0,0,
3,0,0,0,0,0,0,0,0,0,9,0,0,0,0,0,
3,10,0,0,0,0,0,0,0,4,9,0,0,0,4,4,
3,5,0,0,0,0,0,0,0,0,9,0,0,0,5,4,
3,5,0,0,1,0,0,0,0,0,9,0,0,8,5,4,
3,3,3,3,3,3,3,3,3,3,3,3,3,3,3,3,
