3,3,3,3,3,3,3,3,3,3,3,3,3,3,3,3,
5,5,0,0,0,0,0,0,0,0,0,0,0,0,5,5,
5,5,0,0,0,0,0,0,0,0,0,0,0,0,5,5,
3,3,0,0,0,0,0,0,0,0,0,0,0,0,0,0,
3,3,3,0,0,0,0,0,0,0,0,0,0,0,0,0,
3,3,3,3,0,0,0,0,0,0,0,0,0,0,10,0,
3,3,3,3,5,0,0,0,0,0,0,5,0,3,3,3,
3,0,0,0,5,5,0,0,0,0,5,5,0,3,2,0,
3,0,1,0,5,5,5,0,0,5,5,5,0,3,0,0,
3,3,3,3,3,3,3,3,3,3,3,3,3,3,3,3,
