3,3,3,3,3,3,3,3,3,3,3,3,
6,0,0,0,0,0,0,0,0,0,0,0,
6,0,0,0,0,0,0,0,0,3,3,3,
6,0,0,0,0,0,0,0,0,0,2,0,
6,0,0,0,0,0,0,0,0,0,0,0,
6,0,0,3,0,0,0,0,0,0,0,0,
6,0,3,0,10,0,0,0,0,1,0,0,
3,5,3,3,3,3,5,3,3,3,3,3,
