3,3,3,3,3,3,3,3,3,3,3,3,
0,0,0,0,0,0,0,0,0,0,0,6,
1,0,0,0,0,0,3,3,3,3,3,3,
3,3,0,0,0,0,3,2,0,0,0,6,
3,3,3,0,0,0,3,3,3,0,0,6,
0,0,3,3,0,0,0,0,0,0,0,6,
0,0,10,3,3,0,0,0,0,0,0,6,
3,3,3,3,3,3,3,3,3,3,3,3,
