3,3,3,3,3,3,3,3,3,3,3,3,3,3,3,3,
0,0,0,0,0,0,9,0,9,0,0,0,0,0,0,0,
0,5,0,0,0,0,9,9,9,0,0,0,0,0,5,0,
1,0,0,0,0,0,9,9,9,0,0,0,0,0,2,0,
8,4,8,4,0,0,9,9,9,0,0,0,4,0,4,0,
0,0,0,0,0,0,9,9,9,0,0,0,0,0,0,0,
0,0,0,0,0,0,9,9,9,0,0,0,0,0,0,0,
0,0,0,0,0,0,9,9,9,0,0,0,0,0,0,0,
0,8,10,8,0,0,9,9,9,0,0,0,0,0,0,0,
0,0,0,0,3,3,9,3,9,3,3,3,3,3,3,3,
